











  _______  __       __  .___________.  ______  __    __  
 /  _____||  |     |  | |           | /      ||  |  |  | 
|  |  __  |  |     |  | `---|  |----`|  ,----'|  |__|  | 
|  | |_ | |  |     |  |     |  |     |  |     |   __   | 
|  |__| | |  `----.|  |     |  |     |  `----.|  |  |  | 
 \______| |_______||__|     |__|      \______||__|  |__| 

